ParameterName	ParameterValue
environmentFileName	DataCenter.xml
generalizedScenario	1
indoorSwitch	1
mobilitySwitch	0
mobilityType	1
numberOfNodes	2
numberOfTimeDivisions	15
referencePoint	[3,3,2]
selectPlanesByDist	0
switchmodelRray	1
switchDGenerator	1
switchRGenerator	1
switchQDGenerator	1
switchRandomization	0
totalNumberOfReflections	2
totalTimeDuration	15
switchSaveVisualizerFiles	1
carrierFrequency	60e9
qdFilesFloatPrecision	6